NO ./maps/large-gray-wall.xpm
SO ./maps/large-gray-wall.xpm
WE ./maps/large-gray-wall.xpm
EA ./maps/large-gray-wall.xpm

F 0,255,0
C 0,0,255

  1111111111
111000000001
100000000001
100000000001
100000000001
10000N011101
10000001 101
11111111 111